year,team,wins,losses,ties,win_loss_perc,points,points_opp,points_diff,mov,turnovers,total_yards,pass_yds,rush_yds,penalties,exp_pts_tot
2003,1,14,2,,0.875,348,238,110,6.9,24,5039,3432,1607,111,-136.51
2003,2,10,6,,0.625,311,261,50,3.1,34,4609,2792,1817,103,-177.92
2003,3,6,10,,0.375,243,279,-36,-2.3,34,4348,2684,1664,106,-230.07
2003,4,6,10,,0.375,283,299,-16,-1.0,20,4951,3316,1635,69,-107.89
2003,5,10,6,,0.625,391,281,110,6.9,38,4929,2255,2674,126,-220.5
2003,6,8,8,,0.5,346,384,-38,-2.4,22,5329,3342,1987,107,-78.22
2003,7,6,10,,0.375,300,327,-27,-1.7,28,4792,3304,1488,111,-166.93
2003,8,5,11,,0.313,254,322,-68,-4.3,33,4504,2834,1670,98,-191.88
2003,9,12,4,,0.75,447,336,111,6.9,20,5874,4179,1695,92,-13.96
2003,10,12,4,,0.75,435,324,111,6.9,21,5501,3878,1623,110,-103.79
2003,11,5,11,,0.313,276,331,-55,-3.4,31,5358,3285,2073,108,-132.3
2003,12,5,11,,0.313,255,380,-125,-7.8,27,4306,2655,1651,121,-200.45
2003,13,13,3,,0.813,484,332,152,9.5,18,5910,3981,1929,79,36.78
2003,14,10,6,,0.625,381,301,80,5.0,24,5598,2969,2629,107,-127.67
2003,15,4,12,,0.25,270,379,-109,-6.8,26,4573,2751,1822,134,-190.11
2003,16,4,12,,0.25,313,441,-128,-8.0,31,5167,3021,2146,126,-126.67
2003,17,12,4,,0.75,374,287,87,5.4,22,5035,3020,2015,96,-80.82
2003,18,10,6,,0.625,289,260,29,1.8,29,5161,3162,1999,98,-251.47
2003,19,5,11,,0.313,287,372,-85,-5.3,28,4659,3006,1653,124,-182.25
2003,20,4,12,,0.25,243,387,-144,-9.0,38,4942,3383,1559,127,-225.77
2003,21,10,6,,0.625,442,307,135,8.4,32,5798,3240,2558,88,-49.49
2003,22,9,7,,0.563,416,353,63,3.9,24,6294,3951,2343,127,8.32
2003,23,7,9,,0.438,283,346,-63,-3.9,29,4380,2617,1763,92,-215.02
2003,24,5,11,,0.313,270,379,-109,-6.8,28,4262,2924,1338,107,-212.29
2003,25,11,5,,0.688,325,304,21,1.3,31,5141,3050,2091,116,-149.93
2003,26,8,8,,0.5,340,326,14,0.9,28,5438,3438,2000,103,-109.71
2003,27,7,9,,0.438,301,264,37,2.3,31,5453,3805,1648,117,-214.9
2003,28,5,11,,0.313,299,422,-123,-7.7,31,4357,2408,1949,90,-190.61
2003,29,12,4,,0.75,447,328,119,7.4,39,5457,3961,1496,92,-159.0
2003,30,10,6,,0.625,404,327,77,4.8,29,5627,3618,2009,91,-37.4
2003,31,7,9,,0.438,384,337,47,2.9,25,5687,3408,2279,104,-56.95
2003,32,4,12,,0.25,225,452,-227,-14.2,36,4490,2959,1531,98,-250.75
2004,1,14,2,,0.875,437,260,177,11.1,27,5722,3588,2134,101,22.2
2004,4,10,6,,0.625,333,261,72,4.5,16,5438,3050,2388,91,-51.69
2004,3,9,7,,0.563,395,284,111,6.9,29,4691,2817,1874,121,-194.58
2004,2,4,12,,0.25,275,354,-79,-4.9,42,4404,3065,1339,112,-258.56
2004,7,15,1,,0.938,372,251,121,7.6,21,5184,2720,2464,99,-95.61
2004,5,9,7,,0.563,317,268,49,3.1,23,4375,2312,2063,94,-199.99
2004,6,8,8,,0.5,374,372,2,0.1,32,5140,3301,1839,103,-143.68
2004,8,4,12,,0.25,276,390,-114,-7.1,40,4481,2824,1657,115,-244.59
2004,9,12,4,,0.75,522,351,171,10.7,17,6475,4623,1852,106,113.82
2004,11,9,7,,0.563,261,280,-19,-1.2,22,5009,3159,1850,109,-135.64
2004,12,7,9,,0.438,309,339,-30,-1.9,25,5128,3246,1882,106,-97.09
2004,10,5,11,,0.313,344,439,-95,-5.9,31,5487,3616,1871,110,-108.2
2004,16,12,4,,0.75,446,313,133,8.3,18,5542,3357,2185,108,-7.11
2004,14,10,6,,0.625,381,304,77,4.8,29,6332,3999,2333,93,-58.67
2004,13,7,9,,0.438,483,435,48,3.0,27,6695,4406,2289,117,66.99
2004,15,5,11,,0.313,320,442,-122,-7.6,35,5153,3858,1295,134,-132.26
2004,17,13,3,,0.813,386,260,126,7.9,22,5618,3979,1639,124,-11.51
2004,20,6,10,,0.375,303,347,-44,-2.8,24,4722,2818,1904,118,-211.66
2004,18,6,10,,0.375,293,405,-112,-7.0,37,5197,3428,1769,105,-152.34
2004,19,6,10,,0.375,240,265,-25,-1.6,27,4397,2632,1765,115,-213.72
2004,21,10,6,,0.625,424,380,44,2.8,29,6357,4449,1908,116,10.72
2004,22,8,8,,0.5,405,395,10,0.6,21,6339,4516,1823,117,65.96
2004,24,6,10,,0.375,296,350,-54,-3.4,20,4693,2916,1777,121,-132.39
2004,23,5,11,,0.313,231,331,-100,-6.3,37,3816,2192,1624,124,-332.82
2004,28,11,5,,0.688,340,337,3,0.2,30,5084,2412,2672,109,-108.92
2004,26,8,8,,0.5,348,405,-57,-3.6,26,5193,3587,1606,129,-174.82
2004,25,7,9,,0.438,355,339,16,1.0,26,5225,3643,1582,123,-80.29
2004,27,5,11,,0.313,301,304,-3,-0.2,36,4963,3474,1489,117,-201.99
2004,30,9,7,,0.563,371,373,-2,-0.1,27,5634,3539,2095,79,-65.26
2004,29,8,8,,0.5,319,392,-73,-4.6,39,5877,4253,1624,127,-93.92
2004,32,6,10,,0.375,284,322,-38,-2.4,29,4550,2882,1668,124,-202.74
2004,31,2,14,,0.125,259,452,-193,-12.1,40,4585,3136,1449,103,-234.6
2005,1,10,6,,0.625,379,338,41,2.6,24,5632,4120,1512,110,-89.97
2005,2,9,7,,0.563,318,317,1,0.1,30,5198,3300,1898,132,-163.29
2005,3,5,11,,0.313,271,367,-96,-6.0,26,4122,2515,1607,120,-230.91
2005,4,4,12,,0.25,240,355,-115,-7.2,34,3970,2642,1328,98,-185.24
2005,6,11,5,,0.688,421,350,71,4.4,20,5730,3820,1910,110,-62.24
2005,7,11,5,,0.688,389,258,131,8.2,23,5149,2926,2223,99,-59.51
2005,5,6,10,,0.375,265,299,-34,-2.1,36,4693,3088,1605,139,-237.85
2005,8,6,10,,0.375,232,301,-69,-4.3,30,4550,3047,1503,99,-234.39
2005,9,14,2,,0.875,439,247,192,12.0,19,5799,4096,1703,94,77.86
2005,11,12,4,,0.75,361,269,92,5.8,17,5149,3190,1959,121,-117.95
2005,10,4,12,,0.25,299,421,-122,-7.6,26,5122,3597,1525,125,-242.78
2005,12,2,14,,0.125,260,431,-171,-10.7,24,4053,2237,1816,106,-206.24
2005,14,13,3,,0.813,395,258,137,8.6,16,5766,3227,2539,97,-52.48
2005,13,10,6,,0.625,403,325,78,4.9,23,6192,3810,2382,115,-15.0
2005,16,9,7,,0.563,418,312,106,6.6,28,5567,3495,2072,110,-38.32
2005,15,4,12,,0.25,290,383,-93,-5.8,23,4951,3582,1369,147,-147.25
2005,20,11,5,,0.688,422,314,108,6.8,25,5787,3578,2209,143,-92.84
2005,19,10,6,,0.625,359,293,66,4.1,27,5289,3106,2183,108,-118.86
2005,18,9,7,,0.563,325,308,17,1.1,31,5202,3341,1861,99,-158.41
2005,17,6,10,,0.375,310,388,-78,-4.9,34,5109,3677,1432,134,-175.2
2005,23,11,5,,0.688,260,202,58,3.6,28,4101,2002,2099,105,-257.69
2005,22,9,7,,0.563,306,344,-38,-2.4,30,4613,3146,1467,128,-177.98
2005,24,5,11,,0.313,254,345,-91,-5.7,30,4319,2848,1471,115,-187.33
2005,21,4,12,,0.25,298,344,-46,-2.9,45,5118,3766,1352,119,-157.53
2005,27,11,5,,0.688,300,274,26,1.6,23,4716,2890,1826,131,-198.56
2005,25,11,5,,0.688,391,259,132,8.3,26,4950,3271,1679,91,-104.34
2005,28,8,8,,0.5,351,341,10,0.6,29,5225,2679,2546,114,-80.52
2005,26,3,13,,0.188,235,398,-163,-10.2,43,5031,3343,1688,135,-199.14
2005,30,13,3,,0.813,452,271,181,11.3,17,5915,3458,2457,94,48.65
2005,29,6,10,,0.375,363,429,-66,-4.1,37,5571,4036,1535,131,-103.69
2005,32,5,11,,0.313,311,387,-76,-4.8,37,5575,4437,1138,145,-175.55
2005,31,4,12,,0.25,239,428,-189,-11.8,35,3587,1898,1689,106,-278.06
2006,1,12,4,,0.75,385,237,148,9.3,27,5369,3400,1969,98,-76.38
2006,4,10,6,,0.625,316,295,21,1.3,25,4891,3153,1738,70,-133.92
2006,3,7,9,,0.438,300,311,-11,-0.7,29,4271,2719,1552,87,-160.68
2006,2,6,10,,0.375,260,283,-23,-1.4,25,4960,3287,1673,90,-183.26
2006,5,13,3,,0.813,353,201,152,9.5,23,5072,3435,1637,109,-170.15
2006,6,8,8,,0.5,373,331,42,2.6,24,5462,3833,1629,92,-89.47
2006,7,8,8,,0.5,353,315,38,2.4,37,5725,3733,1992,69,-76.32
2006,8,4,12,,0.25,238,356,-118,-7.4,42,4233,2898,1335,74,-306.41
2006,9,12,4,,0.75,427,360,67,4.2,19,6070,4308,1762,86,26.73
2006,10,8,8,,0.5,324,400,-76,-4.8,26,4810,2596,2214,94,-168.4
2006,11,8,8,,0.5,371,274,97,6.1,23,5423,2882,2541,97,-80.6
2006,12,6,10,,0.375,267,366,-99,-6.2,25,4463,2778,1685,90,-127.87
2006,16,14,2,,0.875,492,303,189,11.8,15,5840,3262,2578,90,-0.85
2006,13,9,7,,0.563,331,315,16,1.0,26,5143,3000,2143,76,-88.56
2006,14,9,7,,0.563,319,305,14,0.9,30,4951,2799,2152,67,-139.19
2006,15,2,14,,0.125,168,332,-164,-10.3,46,3939,2420,1519,111,-358.27
2006,17,10,6,,0.625,398,328,70,4.4,24,6103,4119,1984,112,-32.03
2006,18,9,7,,0.563,425,350,75,4.7,30,5772,3836,1936,100,-35.15
2006,20,8,8,,0.5,355,362,-7,-0.4,28,5214,3058,2156,101,-108.77
2006,19,5,11,,0.313,307,376,-69,-4.3,17,5243,3027,2216,106,-66.51
2006,23,13,3,,0.813,427,255,172,10.8,36,5199,3281,1918,112,-133.82
2006,21,8,8,,0.5,301,366,-65,-4.1,33,5458,3795,1663,90,-185.35
2006,22,6,10,,0.375,282,327,-45,-2.8,32,4943,3123,1820,123,-203.52
2006,24,3,13,,0.188,305,398,-93,-5.8,39,4949,3820,1129,116,-187.39
2006,26,10,6,,0.625,413,322,91,5.7,23,6264,4503,1761,79,-100.41
2006,25,8,8,,0.5,270,305,-35,-2.2,27,4923,3264,1659,103,-128.23
2006,28,7,9,,0.438,292,328,-36,-2.3,20,5310,2371,2939,96,-100.14
2006,27,4,12,,0.25,211,353,-142,-8.9,32,4321,2798,1523,87,-287.73
2006,30,9,7,,0.563,335,341,-6,-0.4,34,4977,3054,1923,94,-202.3
2006,29,8,8,,0.5,367,381,-14,-0.9,18,5767,3962,1805,116,-53.93
2006,31,7,9,,0.438,298,412,-114,-7.1,32,4860,2688,2172,93,-179.97
2006,32,5,11,,0.313,314,389,-75,-4.7,30,5000,3662,1338,117,-95.61
2007,1,16,0,,1.0,589,274,315,19.7,15,6580,4731,1849,78,133.73
2007,3,7,9,,0.438,252,354,-102,-6.4,21,4434,2634,1800,78,-172.71
2007,4,4,12,,0.25,268,355,-87,-5.4,25,4715,3014,1701,63,-172.29
2007,2,1,15,,0.063,267,437,-170,-10.6,29,4600,3031,1569,91,-153.67
2007,7,10,6,,0.625,393,269,124,7.8,22,5239,3071,2168,80,-18.96
2007,8,10,6,,0.625,402,382,20,1.3,29,5621,3726,1895,114,-120.58
2007,6,7,9,,0.438,380,385,-5,-0.3,30,5568,4012,1556,90,-57.26
2007,5,5,11,,0.313,275,384,-109,-6.8,40,4832,3035,1797,107,-231.17
2007,9,13,3,,0.813,450,262,188,11.8,19,5739,4033,1706,67,52.46
2007,11,11,5,,0.688,411,304,107,6.7,21,5719,3328,2391,76,-1.73
2007,10,10,6,,0.625,301,297,4,0.3,34,4987,2878,2109,101,-172.57
2007,12,8,8,,0.5,379,384,-5,-0.3,38,5337,3751,1586,82,-86.53
2007,16,11,5,,0.688,412,284,128,8.0,24,5044,3005,2039,94,-114.6
2007,14,7,9,,0.438,320,409,-89,-5.6,29,5541,3584,1957,90,-72.86
2007,13,4,12,,0.25,226,335,-109,-6.8,33,4429,3181,1248,101,-191.37
2007,15,4,12,,0.25,283,398,-115,-7.2,37,4717,2631,2086,120,-187.89
2007,18,13,3,,0.813,455,325,130,8.1,24,5851,4105,1746,104,19.43
2007,20,10,6,,0.625,373,351,22,1.4,34,5302,3154,2148,77,-163.79
2007,19,9,7,,0.563,334,310,24,1.5,29,5334,3463,1871,90,-198.87
2007,17,8,8,,0.5,336,300,36,2.3,27,5729,3755,1974,83,-37.49
2007,21,13,3,,0.813,435,291,144,9.0,24,5931,4334,1597,113,-41.4
2007,22,8,8,,0.5,365,311,54,3.4,30,5379,2745,2634,86,-52.29
2007,24,7,9,,0.438,346,444,-98,-6.1,36,5166,3878,1288,100,-124.39
2007,23,7,9,,0.438,334,348,-14,-0.9,34,4692,3362,1330,111,-194.23
2007,27,9,7,,0.563,334,270,64,4.0,20,5229,3357,1872,81,-156.35
2007,25,7,9,,0.438,267,347,-80,-5.0,29,4559,2735,1824,95,-173.41
2007,26,7,9,,0.438,379,388,-9,-0.6,30,5780,4314,1466,68,-50.3
2007,28,4,12,,0.25,259,414,-155,-9.7,24,4813,3293,1520,105,-199.45
2007,30,10,6,,0.625,393,291,102,6.4,24,5583,3964,1619,59,-107.06
2007,32,8,8,,0.5,404,399,5,0.3,36,5505,4065,1440,137,-176.41
2007,31,5,11,,0.313,219,364,-145,-9.1,34,3797,2320,1477,97,-316.28
2007,29,3,13,,0.188,263,438,-175,-10.9,37,4760,3233,1527,94,-194.74
2008,2,11,5,0.0,0.688,345,317,28,,13,5529,3632,1897,81,-94.02
2008,1,11,5,0.0,0.688,410,309,101,,21,5847,3569,2278,57,-13.1
2008,4,9,7,0.0,0.563,405,356,49,,31,5307,3303,2004,77,-71.83
2008,3,7,9,0.0,0.438,336,342,-6,,30,4882,3040,1842,71,-177.66
2008,7,12,4,0.0,0.75,347,223,124,,25,4991,3301,1690,95,-199.86
2008,5,11,5,0.0,0.688,385,244,141,,21,5184,2808,2376,103,-196.15
2008,6,4,11,1.0,0.281,204,364,-160,,26,3926,2406,1520,75,-273.1
2008,8,4,12,0.0,0.25,232,350,-118,,26,3985,2380,1605,100,-217.96
2008,10,13,3,0.0,0.813,375,234,141,,17,5018,2819,2199,108,-76.91
2008,9,12,4,0.0,0.75,377,298,79,,17,5368,4094,1274,86,13.94
2008,12,8,8,0.0,0.5,366,394,-28,,32,6113,4267,1846,80,-76.35
2008,11,5,11,0.0,0.313,302,367,-65,,24,5106,3332,1774,104,-75.31
2008,16,8,8,0.0,0.5,439,347,92,,20,5584,3858,1726,95,37.86
2008,14,8,8,0.0,0.5,370,448,-78,,30,6333,4471,1862,77,40.33
2008,15,5,11,0.0,0.313,263,388,-125,,23,4356,2369,1987,109,-231.49
2008,13,2,14,0.0,0.125,291,440,-149,,24,4939,3129,1810,78,-123.89
2008,20,12,4,0.0,0.75,427,294,133,,13,5695,3177,2518,102,-47.01
2008,17,9,6,1.0,0.594,416,289,127,,26,5608,3911,1697,74,-106.76
2008,18,9,7,0.0,0.563,362,365,-3,,33,5512,3789,1723,120,-88.66
2008,19,8,8,0.0,0.5,265,296,-31,,18,5120,3025,2095,83,-173.59
2008,22,10,6,0.0,0.625,379,333,46,,31,5288,2956,2332,90,-102.8
2008,23,9,7,0.0,0.563,375,350,25,,27,4734,3061,1673,78,-165.89
2008,21,6,10,0.0,0.375,419,380,39,,21,5618,3813,1805,110,-12.53
2008,24,0,16,0.0,0.0,268,517,-249,,29,4292,2960,1332,88,-180.57
2008,25,12,4,0.0,0.75,414,329,85,,19,5595,3158,2437,94,-47.15
2008,28,11,5,0.0,0.688,391,325,66,,21,5779,3336,2443,71,-18.27
2008,27,9,7,0.0,0.563,361,323,38,,26,5456,3619,1837,95,-192.43
2008,26,8,8,0.0,0.5,463,393,70,,26,6571,4977,1594,86,51.85
2008,32,9,7,0.0,0.563,427,426,1,,30,5852,4674,1178,107,-42.91
2008,31,7,9,0.0,0.438,339,381,-42,,35,4978,3379,1599,98,-133.8
2008,30,4,12,0.0,0.25,294,392,-98,,27,4385,2617,1768,79,-125.55
2008,29,2,14,0.0,0.125,232,465,-233,,31,4596,2947,1649,97,-238.05
2009,1,10,6,,0.625,427,285,142,8.9,22,6357,4436,1921,81,22.9
2009,4,9,7,,0.563,348,236,112,7.0,30,5136,2380,2756,88,-176.01
2009,2,7,9,,0.438,360,390,-30,-1.9,29,5401,3170,2231,78,-80.15
2009,3,6,10,,0.375,258,326,-68,-4.3,30,4382,2515,1867,107,-206.59
2009,6,10,6,,0.625,305,291,14,0.9,25,4946,2890,2056,114,-130.3
2009,5,9,7,,0.563,391,261,130,8.1,22,5619,3419,2200,115,-66.23
2009,7,9,7,,0.563,368,324,44,2.8,25,5941,4148,1793,85,-69.44
2009,8,5,11,,0.313,245,375,-130,-8.1,31,4163,2076,2087,77,-207.34
2009,9,14,2,,0.875,416,307,109,6.8,24,5809,4515,1294,74,43.68
2009,12,9,7,,0.563,388,333,55,3.4,28,6129,4654,1475,95,-28.67
2009,10,8,8,,0.5,354,402,-48,-3.0,31,5623,3031,2592,98,-113.09
2009,11,7,9,,0.438,290,380,-90,-5.6,23,5385,3356,2029,70,-95.89
2009,16,13,3,,0.813,454,320,134,8.4,17,5761,4338,1423,78,-11.67
2009,14,8,8,,0.5,326,324,2,0.1,23,5463,3627,1836,93,-111.32
2009,15,5,11,,0.313,197,379,-182,-11.4,33,4258,2557,1701,117,-296.58
2009,13,4,12,,0.25,294,424,-130,-8.1,27,4851,2922,1929,84,-192.81
2009,18,11,5,,0.688,361,250,111,6.9,19,6390,4287,2103,115,-32.87
2009,17,11,5,,0.688,429,337,92,5.8,23,5726,4089,1637,115,-49.4
2009,20,8,8,,0.5,402,427,-25,-1.6,31,5856,4019,1837,95,-34.71
2009,19,4,12,,0.25,266,336,-70,-4.4,28,5000,3490,1510,85,-155.59
2009,22,12,4,,0.75,470,312,158,9.9,18,6074,4156,1918,101,7.01
2009,21,11,5,,0.688,461,297,164,10.3,16,6065,4180,1885,118,72.34
2009,23,7,9,,0.438,327,375,-48,-3.0,34,4965,3473,1492,100,-206.86
2009,24,2,14,,0.125,262,494,-232,-14.5,41,4784,3168,1616,98,-196.67
2009,26,13,3,,0.813,510,341,169,10.6,28,6461,4355,2106,89,60.76
2009,28,9,7,,0.563,363,325,38,2.4,25,5447,3571,1876,78,-77.35
2009,25,8,8,,0.5,315,308,7,0.4,31,5297,2799,2498,88,-123.58
2009,27,3,13,,0.188,244,400,-156,-9.8,34,4600,2973,1627,93,-226.98
2009,32,10,6,,0.625,375,325,50,3.1,36,5510,4016,1494,108,-116.0
2009,31,8,8,,0.5,330,281,49,3.1,24,4652,3052,1600,98,-137.18
2009,30,5,11,,0.313,280,390,-110,-6.9,31,5069,3503,1566,95,-169.53
2009,29,1,15,,0.063,175,436,-261,-16.3,33,4470,2686,1784,100,-246.26
2010,1,14,2,,0.875,518,313,205,12.8,10,5820,3847,1973,83,73.64
2010,4,11,5,,0.688,367,304,63,3.9,21,5616,3242,2374,103,-122.93
2010,2,7,9,,0.438,273,333,-60,-3.8,31,5170,3527,1643,72,-174.02
2010,3,4,12,,0.25,283,425,-142,-8.9,39,4878,3158,1720,82,-174.07
2010,7,12,4,,0.75,375,232,143,8.9,18,5525,3601,1924,100,-133.72
2010,5,12,4,,0.75,357,270,87,5.4,20,5166,3335,1831,90,-79.88
2010,8,5,11,,0.313,271,332,-61,-3.8,29,4635,2989,1646,78,-169.65
2010,6,4,12,,0.25,322,395,-73,-4.6,34,5289,3767,1522,90,-148.58
2010,9,10,6,,0.625,435,388,47,2.9,25,6092,4609,1483,79,28.65
2010,11,8,8,,0.5,353,419,-66,-4.1,33,5460,3065,2395,83,-35.27
2010,12,6,10,,0.375,390,427,-37,-2.3,18,6186,4144,2042,90,53.17
2010,10,6,10,,0.375,356,339,17,1.1,29,4834,3107,1727,128,-71.69
2010,13,10,6,,0.625,366,326,40,2.5,14,5595,2968,2627,90,-93.85
2010,16,9,7,,0.563,441,322,119,7.4,29,6329,4519,1810,84,27.47
2010,15,8,8,,0.5,410,371,39,2.4,26,5674,3180,2494,148,-110.8
2010,14,4,12,,0.25,344,471,-127,-7.9,27,5582,4038,1544,98,-125.44
2010,17,10,6,,0.625,439,377,62,3.9,25,6230,3906,2324,129,-11.0
2010,20,10,6,,0.625,394,347,47,2.9,42,6085,3885,2200,92,-49.21
2010,18,6,10,,0.375,394,436,-42,-2.6,30,5828,4042,1786,109,-108.16
2010,19,6,10,,0.375,302,377,-75,-4.7,31,5374,3913,1461,90,-134.87
2010,23,11,5,,0.688,334,286,48,3.0,31,4631,3015,1616,91,-227.26
2010,21,10,6,,0.625,388,240,148,9.3,22,5730,4124,1606,78,-45.71
2010,24,6,10,,0.375,362,369,-7,-0.4,25,5423,3810,1613,136,-105.43
2010,22,6,10,,0.375,281,348,-67,-4.2,37,5039,3097,1942,100,-126.19
2010,28,13,3,,0.813,414,288,126,7.9,17,5458,3567,1891,58,-39.55
2010,26,11,5,,0.688,384,307,77,4.8,31,5960,4441,1519,90,-53.15
2010,27,10,6,,0.625,341,318,23,1.4,19,5362,3361,2001,100,-94.23
2010,25,2,14,,0.125,196,408,-212,-13.3,37,4135,2289,1846,106,-280.1
2010,30,7,9,,0.438,310,407,-97,-6.1,31,4765,3341,1424,101,-197.05
2010,29,7,9,,0.438,289,328,-39,-2.4,21,4846,3268,1578,102,-203.89
2010,31,6,10,,0.375,305,346,-41,-2.6,23,5013,3356,1657,112,-95.38
2010,32,5,11,,0.313,289,434,-145,-9.1,35,4309,2921,1388,108,-215.39
2011,1,13,3,,0.813,513,342,171,10.7,17,6848,5084,1764,87,99.08
2011,4,8,8,,0.5,377,363,14,0.9,34,4989,3297,1692,102,-156.9
2011,2,6,10,,0.375,329,313,16,1.0,25,5078,3091,1987,85,-126.5
2011,3,6,10,,0.375,372,434,-62,-3.9,30,5624,3703,1921,86,-104.05
2011,5,12,4,,0.75,378,266,112,7.0,24,5419,3423,1996,92,-72.94
2011,7,12,4,,0.75,325,227,98,6.1,28,5957,4054,1903,101,-91.67
2011,6,9,7,,0.563,344,323,21,1.3,22,5118,3340,1778,99,-104.83
2011,8,4,12,,0.25,218,307,-89,-5.6,19,4621,3090,1531,95,-180.18
2011,12,10,6,,0.625,381,278,103,6.4,20,5954,3506,2448,99,-63.12
2011,10,9,7,,0.563,325,317,8,0.5,22,5361,3923,1438,104,-77.3
2011,11,5,11,,0.313,243,329,-86,-5.4,23,4149,2179,1970,77,-229.23
2011,9,2,14,,0.125,243,430,-187,-11.7,29,4589,2995,1594,76,-156.99
2011,14,8,8,,0.5,309,390,-81,-5.1,30,5066,2434,2632,101,-154.77
2011,16,8,8,,0.5,406,377,29,1.8,28,6290,4426,1864,91,-30.34
2011,15,8,8,,0.5,359,433,-74,-4.6,30,6072,3962,2110,163,-151.03
2011,13,7,9,,0.438,212,338,-126,-7.9,28,4973,3080,1893,110,-185.47
2011,20,9,7,,0.563,394,400,-6,-0.4,24,6161,4734,1427,94,-45.79
2011,17,8,8,,0.5,396,328,68,4.3,38,6386,4110,2276,107,-37.96
2011,18,8,8,,0.5,369,347,22,1.4,21,6008,4201,1807,114,-45.46
2011,19,5,11,,0.313,288,367,-79,-4.9,35,5387,3773,1614,91,-194.94
2011,21,15,1,,0.938,560,359,201,12.6,14,6482,4924,1558,76,92.5
2011,24,10,6,,0.625,474,387,87,5.4,23,6337,4814,1523,128,33.96
2011,23,8,8,,0.5,353,341,12,0.8,29,5026,3011,2015,104,-192.92
2011,22,3,13,,0.188,340,449,-109,-6.8,26,5275,2957,2318,109,-77.5
2011,26,13,3,,0.813,547,339,208,13.0,19,7474,5347,2127,99,165.64
2011,28,10,6,,0.625,402,350,52,3.3,21,6026,4192,1834,93,-22.37
2011,25,6,10,,0.375,406,429,-23,-1.4,23,6237,3829,2408,113,39.94
2011,27,4,12,,0.25,287,494,-207,-12.9,40,5108,3650,1458,123,-185.87
2011,31,13,3,,0.813,380,229,151,9.4,10,4974,2930,2044,113,-152.56
2011,32,8,8,,0.5,312,348,-36,-2.3,32,5192,3567,1625,106,-98.26
2011,30,7,9,,0.438,321,315,6,0.4,23,4861,3105,1756,138,-137.47
2011,29,2,14,,0.125,193,407,-214,-13.4,23,4537,2870,1667,112,-237.06
2012,1,12,4,0.0,0.75,557,331,226,,16,6846,4662,2184,97,118.97
2012,2,7,9,0.0,0.438,288,317,-29,,26,4984,3182,1802,82,-88.66
2012,4,6,10,0.0,0.375,281,375,-94,,37,4787,2891,1896,83,-166.55
2012,3,6,10,0.0,0.375,344,435,-91,,34,5486,3269,2217,104,-100.38
2012,5,10,6,0.0,0.625,398,344,54,,16,5640,3739,1901,121,22.03
2012,6,10,6,0.0,0.625,391,320,71,,26,5323,3578,1745,99,-90.48
2012,7,8,8,0.0,0.5,336,314,22,,30,5324,3787,1537,92,-108.05
2012,8,5,11,0.0,0.313,302,368,-66,,26,5028,3435,1593,113,-139.68
2012,12,12,4,0.0,0.75,416,331,85,,17,5953,3830,2123,108,-20.08
2012,9,11,5,0.0,0.688,357,387,-30,,27,5799,4128,1671,94,-73.11
2012,10,6,10,0.0,0.375,330,471,-141,,28,5010,3323,1687,106,-109.54
2012,11,2,14,0.0,0.125,255,444,-189,,26,4788,3419,1369,101,-192.09
2012,14,13,3,0.0,0.813,481,289,192,,25,6366,4534,1832,100,54.27
2012,16,7,9,0.0,0.438,350,350,0,,26,4756,3295,1461,103,-125.47
2012,15,4,12,0.0,0.25,290,443,-153,,26,5504,4084,1420,108,-118.39
2012,13,2,14,0.0,0.125,211,425,-214,,37,5108,2713,2395,92,-203.56
2012,19,10,6,0.0,0.625,436,388,48,,14,6131,3422,2709,116,-16.5
2012,20,9,7,0.0,0.563,429,344,85,,21,5687,3825,1862,72,-14.71
2012,18,8,8,0.0,0.5,376,400,-24,,29,5994,4729,1265,117,-39.11
2012,17,4,12,0.0,0.25,280,444,-164,,37,5665,3791,1874,98,-174.47
2012,21,11,5,0.0,0.688,433,336,97,,16,5751,4049,1702,103,25.77
2012,22,10,6,0.0,0.625,379,348,31,,23,5385,2751,2634,90,-59.9
2012,23,10,6,0.0,0.625,375,277,98,,24,4969,2999,1970,102,-115.17
2012,24,4,12,0.0,0.25,372,437,-65,,33,6540,4927,1613,103,-59.66
2012,28,13,3,0.0,0.813,419,299,120,,18,5906,4509,1397,55,-18.12
2012,25,7,9,0.0,0.438,357,363,-6,,22,5771,3683,2088,98,2.08
2012,26,7,9,0.0,0.438,461,454,7,,24,6574,4997,1577,104,74.33
2012,27,7,9,0.0,0.438,389,394,-5,,23,5820,3983,1837,101,-32.9
2012,31,11,4,1.0,0.719,397,273,124,,16,5789,3298,2491,109,-15.31
2012,30,11,5,0.0,0.688,412,245,167,,18,5610,3031,2579,110,9.07
2012,29,7,8,1.0,0.469,299,348,-49,,22,5264,3550,1714,130,-136.28
2012,32,5,11,0.0,0.313,250,357,-107,,34,4209,3005,1204,102,-297.04
2013,1,12,4,0.0,0.75,444,338,106,,20,6152,4087,2065,69,100.43
2013,4,8,8,0.0,0.5,290,387,-97,,29,5090,2932,2158,108,-94.9
2013,2,8,8,0.0,0.5,317,335,-18,,26,5007,3567,1440,70,-18.67
2013,3,6,10,0.0,0.375,339,388,-49,,27,5410,3103,2307,110,-59.11
2013,6,11,5,0.0,0.688,430,305,125,,30,5891,4136,1755,102,33.5
2013,7,8,8,0.0,0.5,379,370,9,,24,5400,4017,1383,80,26.81
2013,5,8,8,0.0,0.5,320,352,-32,,29,4918,3590,1328,112,-95.39
2013,8,4,12,0.0,0.25,308,406,-98,,29,5423,4040,1383,104,-83.4
2013,9,11,5,0.0,0.688,391,336,55,,14,5468,3725,1743,66,98.0
2013,10,7,9,0.0,0.438,362,381,-19,,25,5390,3496,1894,101,46.52
2013,11,4,12,0.0,0.25,247,449,-202,,27,4701,3441,1260,96,-130.11
2013,12,2,14,0.0,0.125,276,428,-152,,31,5556,3813,1743,112,-85.06
2013,14,13,3,0.0,0.813,606,399,207,,26,7317,5444,1873,117,277.21
2013,13,11,5,0.0,0.688,430,305,125,,18,5396,3340,2056,101,38.85
2013,16,9,7,0.0,0.563,396,348,48,,21,6293,4328,1965,95,186.29
2013,15,4,12,0.0,0.25,322,453,-131,,31,5340,3340,2000,116,-52.12
2013,17,10,6,0.0,0.625,442,382,60,,19,6676,4110,2566,95,134.05
2013,18,8,8,0.0,0.5,439,432,7,,20,5458,3954,1504,102,88.89
2013,20,7,9,0.0,0.438,294,383,-89,,44,4920,3588,1332,91,-106.96
2013,19,3,13,0.0,0.188,334,478,-144,,34,5915,3751,2164,99,-42.64
2013,21,8,7,1.0,0.531,417,428,-11,,25,6404,4268,2136,86,113.82
2013,23,8,8,0.0,0.5,445,478,-33,,23,6109,4281,1828,85,75.28
2013,24,7,9,0.0,0.438,395,376,19,,34,6274,4482,1792,110,25.59
2013,22,5,10,1.0,0.344,391,480,-89,,32,5508,3427,2081,70,24.52
2013,25,12,4,0.0,0.75,366,241,125,,19,5069,3043,2026,80,90.4
2013,26,11,5,0.0,0.688,414,304,110,,19,6391,4918,1473,95,169.86
2013,28,4,12,0.0,0.25,353,443,-90,,28,5490,4243,1247,91,48.53
2013,27,4,12,0.0,0.25,288,389,-101,,21,4432,2820,1612,121,-79.47
2013,30,13,3,0.0,0.813,417,231,186,,19,5424,3236,2188,128,60.55
2013,31,12,4,0.0,0.75,406,272,134,,18,5180,2979,2201,103,58.16
2013,32,10,6,0.0,0.625,379,324,55,,31,5542,4002,1540,96,-5.74
2013,29,7,9,0.0,0.438,348,364,-16,,21,4877,3125,1752,123,-11.2
2014,1,12,4,0.0,0.75,468,313,155,,13,5848,4121,1727,120,181.12
2014,3,9,7,0.0,0.563,343,289,54,,23,5096,3614,1482,124,-43.33
2014,2,8,8,0.0,0.5,388,373,15,,23,5601,3729,1872,81,74.78
2014,4,4,12,0.0,0.25,283,401,-118,,24,5226,2946,2280,109,-44.92
2014,7,11,5,0.0,0.688,436,368,68,,21,6577,4825,1752,103,156.58
2014,6,10,5,1.0,0.656,365,344,21,,26,5568,3421,2147,102,13.84
2014,5,10,6,0.0,0.625,409,302,107,,20,5838,3819,2019,111,135.24
2014,8,7,9,0.0,0.438,299,337,-38,,23,5193,3465,1728,116,-21.15
2014,9,11,5,0.0,0.688,458,369,89,,31,6506,4894,1612,105,83.73
2014,12,9,7,0.0,0.563,372,307,65,,22,5513,3352,2161,94,13.01
2014,11,3,13,0.0,0.188,249,412,-163,,26,4634,3001,1633,73,-120.53
2014,10,2,14,0.0,0.125,254,438,-184,,26,4859,3412,1447,111,-88.85
2014,14,12,4,0.0,0.75,482,354,128,,20,6446,4661,1785,120,140.4
2014,13,9,7,0.0,0.563,353,281,72,,17,5100,3182,1918,88,52.61
2014,16,9,7,0.0,0.563,348,348,0,,23,5465,4098,1367,111,64.94
2014,15,3,13,0.0,0.188,253,452,-199,,29,4515,3275,1240,116,-139.47
2014,18,12,4,0.0,0.75,467,352,115,,25,6138,3784,2354,105,174.23
2014,17,10,6,0.0,0.625,474,400,74,,36,6348,4356,1992,115,35.17
2014,20,6,10,0.0,0.375,380,400,-20,,28,5875,4272,1603,101,40.61
2014,19,4,12,0.0,0.25,301,438,-137,,31,5738,4047,1691,120,14.06
2014,21,12,4,0.0,0.75,486,348,138,,13,6178,4261,1917,92,172.28
2014,24,11,5,0.0,0.688,321,282,39,,20,5452,4030,1422,118,50.59
2014,22,7,9,0.0,0.438,325,343,-18,,20,5048,3244,1804,100,6.55
2014,23,5,11,0.0,0.313,319,442,-123,,29,5233,3792,1441,113,-11.8
2014,25,7,8,1.0,0.469,339,374,-35,,23,5547,3511,2036,83,44.08
2014,26,7,9,0.0,0.438,401,424,-23,,30,6582,4764,1818,80,151.45
2014,28,6,10,0.0,0.375,381,417,-36,,23,6051,4553,1498,97,61.55
2014,27,2,14,0.0,0.125,277,410,-133,,33,4672,3297,1375,118,-67.27
2014,30,12,4,0.0,0.75,394,254,140,,14,6012,3250,2762,130,137.18
2014,32,11,5,0.0,0.688,310,299,11,,17,5116,3808,1308,91,-9.8
2014,31,8,8,0.0,0.5,306,340,-34,,22,5239,3063,2176,116,13.79
2014,29,6,10,0.0,0.375,324,354,-30,,27,5035,3400,1635,123,-44.13
2015,1,12,4,,0.75,465,315,150,9.4,14,5991,4587,1404,96,138.04
2015,4,10,6,,0.625,387,314,73,4.6,24,5925,4057,1868,96,72.26
2015,3,8,8,,0.5,379,359,20,1.3,19,5775,3343,2432,143,37.71
2015,2,6,10,,0.375,310,389,-79,-4.9,19,5307,3811,1496,134,-4.88
2015,6,12,4,,0.75,419,279,140,8.8,17,5728,3923,1805,111,82.59
2015,7,10,6,,0.625,423,319,104,6.5,28,6327,4603,1724,94,22.98
2015,5,5,11,,0.313,328,401,-73,-4.6,28,5749,4271,1478,122,-47.16
2015,8,3,13,,0.188,278,432,-154,-9.6,30,5311,3782,1529,120,-66.22
2015,12,9,7,,0.563,339,313,26,1.6,20,5564,3833,1731,107,-38.02
2015,9,8,8,,0.5,333,408,-75,-4.7,30,5142,3704,1438,108,-51.38
2015,11,5,11,,0.313,376,448,-72,-4.5,28,5581,4108,1473,105,-28.13
2015,10,3,13,,0.188,299,423,-124,-7.8,33,4988,3503,1485,93,-89.79
2015,14,12,4,,0.75,355,296,59,3.7,31,5688,3970,1718,115,-50.98
2015,13,11,5,,0.688,405,287,118,7.4,15,5299,3255,2044,104,41.53
2015,15,7,9,,0.438,359,399,-40,-2.5,24,5336,3879,1457,139,4.72
2015,16,4,12,,0.25,320,398,-78,-4.9,24,5949,4591,1358,117,10.76
2015,19,9,7,,0.563,388,379,9,0.6,22,5661,4095,1566,105,54.93
2015,17,7,9,,0.438,377,430,-53,-3.3,31,5830,4087,1743,104,1.07
2015,20,6,10,,0.375,420,442,-22,-1.4,21,5952,4343,1609,102,31.24
2015,18,4,12,,0.25,275,374,-99,-6.2,33,5361,3471,1890,112,-51.92
2015,22,11,5,,0.688,365,302,63,3.9,17,5139,2928,2211,88,29.39
2015,21,10,6,,0.625,368,323,45,2.8,17,5353,3503,1850,105,40.61
2015,24,7,9,,0.438,358,400,-42,-2.6,24,5547,4212,1335,104,31.8
2015,23,6,10,,0.375,335,397,-62,-3.9,21,5514,3660,1854,99,8.41
2015,25,15,1,,0.938,500,308,192,12.0,19,5871,3589,2282,103,115.28
2015,28,8,8,,0.5,339,345,-6,-0.4,30,5985,4379,1606,100,52.68
2015,26,7,9,,0.438,408,476,-68,-4.3,20,6461,4970,1491,130,146.68
2015,27,6,10,,0.375,342,417,-75,-4.7,28,6014,3852,2162,143,40.62
2015,32,13,3,,0.813,489,313,176,11.0,24,6533,4616,1917,94,148.43
2015,30,10,6,,0.625,423,277,146,9.1,16,6058,3790,2268,117,129.31
2015,29,7,9,,0.438,280,330,-50,-3.1,22,4761,2805,1956,122,-87.66
2015,31,5,11,,0.313,238,387,-149,-9.3,17,4860,3316,1544,113,-46.9
2016,1,14,2,0.0,0.875,441,250,191,,11,6180,4308,1872,93,113.38
2016,2,10,6,0.0,0.625,363,380,-17,,23,5324,3500,1824,125,-48.39
2016,3,7,9,0.0,0.438,399,378,21,,12,5666,3036,2630,112,60.85
2016,4,5,11,0.0,0.313,275,409,-134,,34,5268,3466,1802,93,-79.69
2016,7,11,5,0.0,0.688,399,327,72,,18,5962,4202,1760,112,-22.48
2016,5,8,8,0.0,0.5,343,321,22,,23,5563,4100,1463,125,-86.39
2016,6,6,9,1.0,0.406,325,315,10,,17,5711,3942,1769,88,30.41
2016,8,1,15,0.0,0.063,264,452,-188,,25,4976,3264,1712,95,-72.41
2016,12,9,7,0.0,0.563,279,328,-49,,24,5035,3176,1859,87,-102.3
2016,10,9,7,0.0,0.563,381,378,3,,18,5728,3541,2187,110,-10.0
2016,9,8,8,0.0,0.5,411,392,19,,22,5830,4202,1628,103,68.23
2016,11,3,13,0.0,0.188,318,400,-82,,29,5359,3728,1631,129,-67.5
2016,13,12,4,0.0,0.75,389,311,78,,17,5488,3740,1748,109,-23.04
2016,15,12,4,0.0,0.75,416,385,31,,14,5973,4051,1922,147,-24.48
2016,14,9,7,0.0,0.563,333,297,36,,25,5169,3685,1484,119,-94.99
2016,16,5,11,0.0,0.313,410,423,-13,,35,5708,4198,1510,107,-29.1
2016,18,13,3,0.0,0.813,421,306,115,,15,6027,3631,2396,105,86.3
2016,20,11,5,0.0,0.688,310,284,26,,27,5291,3879,1412,88,-74.19
2016,19,8,7,1.0,0.531,396,383,13,,21,6454,4758,1696,110,105.24
2016,17,7,9,0.0,0.438,367,331,36,,20,5398,3585,1813,113,-45.33
2016,21,10,6,0.0,0.625,432,388,44,,17,5900,4199,1701,100,115.16
2016,24,9,7,0.0,0.563,346,358,-12,,15,5421,4111,1310,100,30.86
2016,22,8,8,0.0,0.5,327,307,20,,16,5041,3836,1205,103,-60.91
2016,23,3,13,0.0,0.188,279,399,-120,,31,5704,3969,1735,110,-70.06
2016,28,11,5,0.0,0.688,540,406,134,,11,6653,4725,1928,104,212.07
2016,27,9,7,0.0,0.563,354,369,-15,,27,5542,3926,1616,109,-33.29
2016,26,7,9,0.0,0.438,469,454,15,,24,6816,5074,1742,107,76.86
2016,25,6,10,0.0,0.375,369,402,-33,,29,5499,3685,1814,98,-81.23
2016,30,10,5,1.0,0.656,354,292,62,,18,5715,4124,1591,117,-11.48
2016,32,7,8,1.0,0.469,418,362,56,,28,5868,4136,1732,104,-25.79
2016,447,4,12,0.0,0.25,224,394,-170,,29,4203,2951,1252,126,-190.35
2016,31,2,14,0.0,0.125,309,480,-171,,25,4930,2911,2019,99,-75.71
2017,1,13,3,,0.813,458,296,162,10.1,12,6307,4418,1889,95,114.84
2017,3,9,7,,0.563,302,359,-57,-3.6,16,4842,2825,2017,98,-156.16
2017,2,6,10,,0.375,281,393,-112,-7.0,29,4923,3535,1388,137,-156.17
2017,4,5,11,,0.313,298,382,-84,-5.3,24,4884,3182,1702,119,-119.83
2017,7,13,3,,0.813,406,308,98,6.1,20,6047,4380,1667,101,-32.55
2017,5,9,7,,0.563,395,303,92,5.8,17,4886,3030,1856,91,-132.06
2017,6,7,9,,0.438,290,349,-59,-3.7,23,4488,3122,1366,110,-108.45
2017,8,0,16,,0.0,234,410,-176,-11.0,41,4942,3228,1714,110,-233.13
2017,11,10,6,,0.625,417,268,149,9.3,23,5855,3593,2262,112,-36.01
2017,10,9,7,,0.563,334,356,-22,-1.4,25,5024,3191,1833,85,-134.32
2017,9,4,12,,0.25,263,404,-141,-8.8,15,4553,2892,1661,92,-189.77
2017,12,4,12,,0.25,338,436,-98,-6.1,28,5120,3278,1842,124,-78.81
2017,13,10,6,,0.625,415,339,76,4.8,11,6007,4104,1903,118,-22.58
2017,462,9,7,,0.563,355,272,83,5.2,15,6026,4431,1595,108,-17.69
2017,15,6,10,,0.375,301,373,-72,-4.5,28,5185,3631,1554,114,-84.71
2017,14,5,11,,0.313,289,382,-93,-5.8,34,5185,3333,1852,113,-165.14
2017,17,13,3,,0.813,457,295,162,10.1,20,5852,3737,2115,116,21.06
2017,18,9,7,,0.563,354,332,22,1.4,22,5311,3141,2170,97,-40.65
2017,19,7,9,,0.438,342,388,-46,-2.9,27,5199,3751,1448,92,-95.51
2017,20,3,13,,0.188,246,388,-142,-8.9,22,5028,3479,1549,91,-167.56
2017,22,13,3,,0.813,382,252,130,8.1,14,5710,3753,1957,100,-54.08
2017,24,9,7,,0.563,410,376,34,2.1,22,5404,4183,1221,104,-93.68
2017,21,7,9,,0.438,320,384,-64,-4.0,25,4891,3167,1724,96,-61.83
2017,23,5,11,,0.313,264,320,-56,-3.5,22,4599,2811,1788,115,-115.2
2017,26,11,5,,0.688,448,326,122,7.6,18,6259,4189,2070,105,7.38
2017,25,11,5,,0.688,363,327,36,2.3,22,5179,3077,2102,83,-100.34
2017,28,10,6,,0.625,353,315,38,2.4,18,5837,3990,1847,102,-46.05
2017,27,5,11,,0.313,335,382,-47,-2.9,27,5814,4366,1448,104,-52.32
2017,447,11,5,,0.688,478,329,149,9.3,21,5784,3831,1953,107,-43.18
2017,30,9,7,,0.563,366,332,34,2.1,17,5286,3657,1629,148,-78.12
2017,32,8,8,,0.5,295,361,-66,-4.1,25,5026,3640,1386,110,-185.97
2017,31,6,10,,0.375,331,383,-52,-3.3,23,5587,3925,1662,123,-173.95
2018,1,11,5,0.0,0.688,436,325,111,,18,6295,4258,2037,93,190.96
2018,2,7,9,0.0,0.438,319,433,-114,,23,4638,2900,1738,108,-40.39
2018,3,6,10,0.0,0.375,269,374,-105,,32,4778,2794,1984,116,-104.81
2018,4,4,12,0.0,0.25,333,441,-108,,30,4787,3165,1622,114,-97.45
2018,5,10,6,0.0,0.625,389,287,102,,20,5999,3558,2441,116,72.85
2018,7,9,6,1.0,0.594,428,360,68,,26,6453,5008,1445,111,156.16
2018,8,7,8,1.0,0.469,359,392,-33,,24,5900,4007,1893,112,36.91
2018,6,6,10,0.0,0.375,368,455,-87,,17,4972,3290,1682,114,47.57
2018,12,11,5,0.0,0.688,402,316,86,,16,5802,3781,2021,105,84.1
2018,9,10,6,0.0,0.625,433,344,89,,24,6179,4461,1718,120,140.47
2018,10,9,7,0.0,0.563,310,303,7,,18,5002,2975,2027,82,10.48
2018,11,5,11,0.0,0.313,245,316,-71,,29,4832,3109,1723,121,-98.17
2018,13,12,4,0.0,0.75,565,421,144,,18,6810,4955,1855,137,298.14
2018,462,12,4,0.0,0.75,428,329,99,,19,5962,4089,1873,113,170.19
2018,14,6,10,0.0,0.375,329,349,-20,,21,5602,3695,1907,125,24.23
2018,15,4,12,0.0,0.25,290,467,-177,,24,5379,3751,1628,110,-17.92
2018,18,10,6,0.0,0.625,339,324,15,,17,5501,3538,1963,104,83.04
2018,17,9,7,0.0,0.563,367,348,19,,23,5845,4275,1570,100,91.97
2018,19,7,9,0.0,0.438,281,359,-78,,19,4795,3021,1774,115,-34.07
2018,20,5,11,0.0,0.313,369,412,-43,,19,5697,4047,1650,114,70.53
2018,23,12,4,0.0,0.75,421,283,138,,24,5502,3564,1938,97,96.31
2018,22,8,7,1.0,0.531,360,341,19,,20,5529,4036,1493,92,7.47
2018,21,6,9,1.0,0.406,376,400,-24,,15,5905,4238,1667,108,108.88
2018,24,6,10,0.0,0.375,324,360,-36,,19,5236,3576,1660,94,39.87
2018,26,13,3,0.0,0.813,504,353,151,,16,6067,4042,2025,94,237.73
2018,28,7,9,0.0,0.438,414,423,-9,,18,6226,4653,1573,101,155.08
2018,25,7,9,0.0,0.438,376,382,-6,,22,5972,3836,2136,92,117.24
2018,27,5,11,0.0,0.313,396,464,-68,,35,6648,5125,1523,117,121.14
2018,447,13,3,0.0,0.813,527,384,143,,19,6738,4507,2231,96,239.79
2018,30,10,6,0.0,0.625,428,347,81,,11,5653,3093,2560,111,128.78
2018,31,4,12,0.0,0.25,342,435,-93,,32,5769,3867,1902,112,20.95
2018,32,3,13,0.0,0.188,225,425,-200,,28,3865,2523,1342,101,-155.06
2019,1,12,4,0.0,0.75,420,225,195,,15,5664,3961,1703,94,34.62
2019,3,10,6,0.0,0.625,314,259,55,,19,5283,3229,2054,117,6.66
2019,4,7,9,0.0,0.438,276,359,-83,,25,4368,3111,1257,115,-112.92
2019,2,5,11,0.0,0.313,306,494,-188,,26,4960,3804,1156,92,-28.85
2019,5,14,2,0.0,0.875,531,282,249,,15,6521,3225,3296,109,239.99
2019,7,8,8,0.0,0.5,289,303,-14,,30,4428,2981,1447,111,-85.56
2019,8,6,10,0.0,0.375,335,393,-58,,28,5455,3554,1901,122,13.54
2019,6,2,14,0.0,0.125,279,420,-141,,30,5169,3652,1517,93,-60.73
2019,12,10,6,0.0,0.625,378,385,-7,,22,5792,3783,2009,111,118.67
2019,10,9,7,0.0,0.563,402,331,71,,17,5805,3582,2223,99,115.88
2019,9,7,9,0.0,0.438,361,373,-12,,21,5238,3108,2130,79,74.8
2019,11,6,10,0.0,0.375,300,397,-97,,20,5468,3760,1708,132,-23.15
2019,13,12,4,0.0,0.75,451,308,143,,15,6067,4498,1569,107,263.38
2019,14,7,9,0.0,0.438,282,316,-34,,16,4777,3115,1662,110,-14.61
2019,15,7,9,0.0,0.438,313,419,-106,,17,5819,3926,1893,128,79.57
2019,462,5,11,0.0,0.313,337,345,-8,,31,5879,4426,1453,103,82.43
2019,17,9,7,0.0,0.563,385,354,31,,23,5772,3833,1939,100,59.85
2019,18,8,8,0.0,0.5,434,321,113,,18,6904,4751,2153,109,210.77
2019,20,4,12,0.0,0.25,341,451,-110,,33,5416,3731,1685,90,-10.3
2019,19,3,13,0.0,0.188,266,435,-169,,21,4395,2812,1583,106,-88.3
2019,21,13,3,0.0,0.813,376,313,63,,13,5528,3733,1795,100,113.4
2019,22,10,6,0.0,0.625,407,303,104,,20,5656,3523,2133,96,98.01
2019,23,8,8,0.0,0.5,280,298,-18,,19,4749,3291,1458,103,-41.05
2019,24,3,12,1.0,0.219,341,423,-82,,23,5549,3900,1649,113,31.07
2019,26,13,3,0.0,0.813,458,341,117,,8,5982,4244,1738,120,163.04
2019,28,7,9,0.0,0.438,381,399,-18,,25,6075,4714,1361,119,95.51
2019,27,7,9,0.0,0.438,458,449,9,,41,6366,4845,1521,133,37.0
2019,25,5,11,0.0,0.313,340,470,-130,,35,5469,3650,1819,87,-28.07
2019,31,13,3,0.0,0.813,479,310,169,,23,6097,3792,2305,105,140.39
2019,30,11,5,0.0,0.688,405,398,7,,20,5991,3791,2200,109,86.55
2019,447,9,7,0.0,0.563,394,364,30,,24,5998,4499,1499,118,37.09
2019,32,5,10,1.0,0.344,361,442,-81,,18,5467,3477,1990,121,64.36
2020,3,13,3,0.0,0.813,501,375,126,,22,6343,4620,1723,102,228.66
2020,2,10,6,0.0,0.625,404,338,66,,20,5424,3736,1688,74,61.96
2020,1,7,9,0.0,0.438,326,353,-27,,19,5236,2890,2346,62,55.88
2020,4,2,14,0.0,0.125,243,457,-214,,19,4479,2796,1683,101,-59.07
2020,7,12,4,0.0,0.75,416,312,104,,18,5354,4003,1351,81,78.22
2020,5,11,5,0.0,0.688,468,303,165,,18,5810,2739,3071,104,148.3
2020,8,11,5,0.0,0.688,408,419,-11,,16,5913,3539,2374,100,159.48
2020,6,4,11,1.0,0.281,311,424,-113,,24,5116,3448,1668,83,-5.13
2020,10,11,5,0.0,0.688,491,439,52,,12,6343,3653,2690,86,245.01
2020,9,11,5,0.0,0.688,451,362,89,,15,6049,4053,1996,94,168.41
2020,12,4,12,0.0,0.25,384,464,-80,,18,6004,4538,1466,80,140.22
2020,11,1,15,0.0,0.063,306,492,-186,,25,5218,3699,1519,107,-6.12
2020,13,14,2,0.0,0.875,473,362,111,,16,6653,4854,1799,105,280.82
2020,558,8,8,0.0,0.5,434,478,-44,,26,6133,4217,1916,98,147.62
2020,462,7,9,0.0,0.438,384,426,-42,,16,6113,4329,1784,85,129.6
2020,14,5,11,0.0,0.313,323,446,-123,,32,5369,3451,1918,81,-21.82
2020,561,7,9,0.0,0.438,335,329,6,,27,5076,3465,1611,87,-10.43
2020,20,6,10,0.0,0.375,280,357,-77,,22,4794,3026,1768,81,-26.79
2020,18,6,10,0.0,0.375,395,473,-78,,26,5949,4161,1788,96,58.97
2020,17,4,11,1.0,0.281,334,418,-84,,29,5354,3327,2027,107,-13.65
2020,21,13,3,0.0,0.813,509,369,140,,11,6224,4106,2118,84,290.75
2020,23,8,8,0.0,0.5,372,370,2,,22,5302,3655,1647,88,34.92
2020,22,7,9,0.0,0.438,430,475,-45,,23,6292,4009,2283,82,157.7
2020,24,5,11,0.0,0.313,377,519,-142,,21,5603,4104,1499,95,94.78
2020,26,12,4,0.0,0.75,482,337,145,,17,6023,3758,2265,98,176.94
2020,27,11,5,0.0,0.688,492,355,137,,17,6145,4626,1519,84,246.24
2020,25,5,11,0.0,0.313,350,402,-52,,21,5592,3888,1704,95,81.2
2020,28,4,12,0.0,0.25,396,414,-18,,18,5895,4363,1532,83,129.77
2020,30,12,4,0.0,0.75,459,371,88,,18,5912,3941,1971,84,129.24
2020,447,10,6,0.0,0.625,372,296,76,,25,6032,4014,2018,71,57.24
2020,32,8,8,0.0,0.5,410,367,43,,21,6153,3916,2237,113,103.62
2020,31,6,10,0.0,0.375,376,390,-14,,31,5922,4033,1889,85,55.7
2021,3,11,6,0.0,0.647,483,289,194,,22,6493,4284,2209,113,216.68
2021,1,10,7,0.0,0.588,462,303,159,,23,6008,3857,2151,95,126.97
2021,2,9,8,0.0,0.529,341,373,-32,,26,5219,3651,1568,105,-11.96
2021,4,4,13,0.0,0.235,310,504,-194,,27,5208,3541,1667,103,-32.71
2021,6,10,7,0.0,0.588,460,376,84,,21,6145,4403,1742,72,118.5
2021,7,9,7,1.0,0.559,343,398,-55,,20,5361,3778,1583,106,-14.49
2021,8,8,9,0.0,0.471,349,371,-22,,22,5791,3320,2471,112,58.49
2021,5,8,9,0.0,0.471,387,392,-5,,26,6440,3961,2479,102,59.67
2021,10,12,5,0.0,0.706,419,354,65,,25,5822,3418,2404,103,79.19
2021,9,9,8,0.0,0.529,451,365,86,,19,5901,3361,2540,76,127.06
2021,12,4,13,0.0,0.235,280,452,-172,,22,4727,3305,1422,114,-74.29
2021,11,3,14,0.0,0.176,253,457,-204,,29,5191,3436,1755,104,-42.52
2021,13,12,5,0.0,0.706,480,364,116,,25,6746,4791,1955,111,261.77
2021,558,10,7,0.0,0.588,374,439,-65,,24,6184,4567,1617,124,77.89
2021,462,9,8,0.0,0.529,474,459,15,,22,6634,4800,1834,116,164.91
2021,14,7,10,0.0,0.412,335,322,13,,18,5618,3593,2025,83,61.32
2021,18,12,5,0.0,0.706,530,358,172,,20,6919,4800,2119,127,158.06
2021,17,9,8,0.0,0.529,444,385,59,,16,6119,3404,2715,107,113.05
2021,561,7,10,0.0,0.412,335,434,-99,,24,5502,3441,2061,82,15.8
2021,20,4,13,0.0,0.235,258,416,-158,,30,4884,3196,1688,88,-100.13
2021,21,13,4,0.0,0.765,450,371,79,,13,6215,4315,1900,69,180.42
2021,22,8,9,0.0,0.471,425,426,-1,,13,6168,4238,1930,111,72.05
2021,23,6,11,0.0,0.353,311,407,-96,,29,5225,3207,2018,106,-40.89
2021,24,3,13,1.0,0.206,325,467,-142,,23,5484,3598,1886,105,6.87
2021,27,13,4,0.0,0.765,511,353,158,,19,6901,5229,1672,97,216.14
2021,26,9,8,0.0,0.529,364,335,29,,18,5177,3186,1991,98,-11.97
2021,28,7,10,0.0,0.412,313,459,-146,,26,5164,3713,1451,92,-18.38
2021,25,5,12,0.0,0.294,304,404,-100,,29,5081,3239,1842,107,-92.1
2021,447,12,5,0.0,0.706,460,372,88,,23,6325,4642,1683,76,161.53
2021,32,11,6,0.0,0.647,449,366,83,,15,6352,4276,2076,114,119.94
2021,31,10,7,0.0,0.588,427,365,62,,24,6387,4221,2166,102,130.03
2021,30,7,10,0.0,0.412,395,366,29,,13,5506,3432,2074,97,101.56
2022,3,13,3,0.0,0.813,455,286,169,,27,6361,4129,2232,92,157.46
2022,2,9,8,0.0,0.529,397,399,-2,,21,6197,4511,1686,111,79.06
2022,1,8,9,0.0,0.471,364,347,17,,23,5348,3536,1812,104,-25.81
2022,4,7,10,0.0,0.412,296,316,-20,,23,5409,3723,1686,91,-47.59
2022,6,12,4,0.0,0.75,418,322,96,,18,5768,4240,1528,81,147.62
2022,5,10,7,0.0,0.588,350,315,35,,21,5760,3040,2720,82,48.17
2022,7,9,8,0.0,0.529,308,346,-38,,19,5484,3411,2073,94,42.17
2022,8,7,10,0.0,0.412,361,381,-20,,21,5934,3444,2490,102,58.03
2022,11,9,8,0.0,0.529,404,350,54,,22,6075,3959,2116,90,103.21
2022,10,7,10,0.0,0.412,298,359,-61,,23,5045,2914,2131,111,-27.22
2022,9,4,12,1.0,0.265,289,427,-138,,34,5298,3432,1866,89,-110.46
2022,12,3,13,1.0,0.206,289,420,-131,,28,4820,3344,1476,88,-120.59
2022,13,14,3,0.0,0.824,496,369,127,,23,7032,5062,1970,87,281.0
2022,462,10,7,0.0,0.588,391,384,7,,19,6108,4584,1524,81,75.75
2022,558,6,11,0.0,0.353,395,418,-23,,21,5993,3934,2059,113,74.09
2022,14,5,12,0.0,0.294,287,359,-72,,24,5527,3592,1935,113,-41.62
2022,17,14,3,0.0,0.824,477,344,133,,19,6614,4105,2509,90,226.96
2022,18,12,5,0.0,0.706,467,342,125,,23,6034,3736,2298,104,112.34
2022,20,9,7,1.0,0.559,365,371,-6,,16,5676,3157,2519,106,78.05
2022,628,8,8,1.0,0.5,321,343,-22,,23,5615,3472,2143,92,-24.27
2022,22,13,4,0.0,0.765,424,427,-3,,23,6145,4484,1661,88,89.64
2022,24,9,8,0.0,0.529,453,427,26,,15,6460,4281,2179,90,162.04
2022,21,8,9,0.0,0.471,370,371,-1,,22,5745,3632,2113,89,68.9
2022,23,3,14,0.0,0.176,326,463,-137,,25,5233,2219,3014,80,-7.14
2022,27,8,9,0.0,0.471,313,358,-45,,22,5894,4586,1308,99,1.03
2022,25,7,10,0.0,0.412,347,374,-27,,21,5206,2996,2210,104,-5.06
2022,26,7,10,0.0,0.412,330,345,-15,,25,5674,3692,1982,99,17.3
2022,28,7,10,0.0,0.412,365,386,-21,,21,5417,2699,2718,68,73.69
2022,31,13,4,0.0,0.765,450,277,173,,17,6216,3856,2360,94,161.29
2022,30,9,8,0.0,0.529,407,401,6,,23,5976,3934,2042,106,63.6
2022,447,5,12,0.0,0.294,307,384,-77,,23,4769,3108,1661,76,-7.51
2022,32,4,13,0.0,0.235,340,449,-109,,25,5499,3626,1873,118,-36.27
2023,3,11,6,,0.647,451,311,140,8.2,28,6366,4154,2212,106,183.02
2023,2,11,6,,0.647,496,391,105,6.2,25,6822,4514,2308,97,128.9
2023,4,7,10,,0.412,268,355,-87,-5.1,33,4566,2919,1647,124,-199.77
2023,1,4,13,,0.235,236,366,-130,-7.6,29,4696,3069,1627,89,-157.57
2023,5,13,4,,0.765,483,280,203,11.9,19,6296,3635,2661,102,130.64
2023,8,11,6,,0.647,396,362,34,2.0,37,5710,3693,2017,115,-110.55
2023,7,10,7,,0.588,304,324,-20,-1.2,16,5173,3163,2010,86,-16.68
2023,6,9,8,,0.529,366,384,-18,-1.1,16,5422,3895,1527,76,41.53
2023,12,10,7,,0.588,377,353,24,1.4,14,5820,4173,1647,114,54.44
2023,11,9,8,,0.529,377,371,6,0.4,30,5772,4126,1646,83,13.64
2023,9,9,8,,0.529,396,415,-19,-1.1,22,5725,3666,2059,95,30.12
2023,10,6,11,,0.353,305,367,-62,-3.6,20,4913,3067,1846,110,3.82
2023,13,11,6,,0.647,371,294,77,4.5,28,5972,4188,1784,96,68.59
2023,558,8,9,,0.471,332,331,1,0.1,24,4922,3380,1542,75,-27.95
2023,14,8,9,,0.471,357,413,-56,-3.3,22,5072,3262,1810,99,7.68
2023,462,5,12,,0.294,346,398,-52,-3.1,21,5599,3957,1642,79,-5.38
2023,18,12,5,,0.706,509,315,194,11.4,16,6317,4397,1920,115,192.72
2023,17,11,6,,0.647,433,428,5,0.3,28,6024,3834,2190,95,100.97
2023,20,6,11,,0.353,266,407,-141,-8.3,19,4760,2886,1874,89,-130.06
2023,628,4,13,,0.235,329,518,-189,-11.1,32,5317,3725,1592,87,-29.99
2023,24,12,5,,0.706,461,395,66,3.9,23,6712,4401,2311,97,160.58
2023,21,9,8,,0.529,383,350,33,1.9,18,5873,3968,1905,105,151.14
2023,22,7,10,,0.412,344,362,-18,-1.1,34,5912,4359,1553,89,42.62
2023,23,7,10,,0.412,360,379,-19,-1.1,25,5495,3096,2399,99,-10.73
2023,27,9,8,,0.529,348,325,23,1.4,18,5321,3812,1509,100,49.53
2023,26,9,8,,0.529,402,327,75,4.4,18,5732,3990,1742,96,46.88
2023,28,7,10,,0.412,321,373,-52,-3.1,28,5683,3524,2159,84,-32.52
2023,25,2,15,,0.118,236,416,-180,-10.6,20,4510,2741,1769,103,-135.03
2023,31,12,5,,0.706,491,298,193,11.4,18,6773,4384,2389,101,231.48
2023,447,10,7,,0.588,404,377,27,1.6,18,6108,4063,2045,89,133.32
2023,30,9,8,,0.529,364,402,-38,-2.2,17,5490,3910,1580,111,62.33
2023,32,4,13,,0.235,330,455,-125,-7.4,18,5509,3144,2365,101,-2.99
